//1,2,3,4,5,6,7,8,9,10,11,12,13,14,15,16,17,18,19,20,21,22,23,24,25,26,27,28,29,30,31,32,33,34,35,36,37,38,39,40,41,42,43,44,45,46,47,48
100,100,100,100,100,100,100,100,100,100,100,100,0,0,0,0,0,0,0,0,0,0,0,0,0,0,0,0,0,0,0,0,0,0,0,0,0,0,0,0,0,0,0,0,0,0,0,0
100,100,100,100,100,100,100,100,100,100,100,100,0,0,0,0,0,0,0,0,0,0,0,0,0,0,0,0,0,0,0,0,0,0,0,0,0,0,0,0,0,0,0,0,0,0,0,0
100,100,100,100,100,100,100,100,100,100,97,0,0,0,0,0,0,0,0,0,0,0,0,0,0,0,0,0,0,0,0,0,0,0,0,0,0,0,0,0,0,0,0,0,0,0,0,0
97,97,97,0,0,0,0,0,0,97,0,0,0,0,0,0,0,0,0,0,0,0,0,0,0,0,0,0,0,0,0,0,0,0,0,0,0,0,0,0,0,0,0,0,0,0,0,0
97,97,0,0,0,0,0,0,0,97,0,0,0,114,114,0,0,0,0,0,0,0,0,0,0,0,0,0,0,0,0,0,0,0,0,0,0,0,0,0,0,0,0,0,0,0,0,0
97,0,0,0,0,0,0,0,0,97,0,100,100,100,100,100,97,0,0,0,0,0,0,0,0,0,0,0,0,0,0,0,0,20,0,0,0,0,20,0,0,0,0,0,0,0,0,0
97,0,0,0,0,0,0,0,0,0,0,0,100,100,100,97,97,0,0,0,0,0,0,0,0,0,0,0,0,0,0,0,20,100,98,98,98,98,100,0,0,0,0,0,0,0,0,0
0,0,0,0,0,0,0,0,0,0,0,0,0,97,0,97,0,0,0,0,0,2,114,114,114,0,2,0,0,0,0,97,100,100,100,98,98,100,100,0,0,0,0,0,0,0,0,0
0,0,0,0,0,0,0,0,0,0,0,0,0,97,0,97,0,0,0,0,100,100,100,100,100,98,100,100,97,0,0,97,100,100,100,100,98,100,97,0,0,0,0,0,0,0,0,0
0,0,0,0,0,0,0,0,0,0,0,0,0,97,0,0,0,0,0,0,97,100,100,100,100,100,100,100,97,0,0,97,100,100,100,100,100,100,97,0,0,0,0,0,0,0,0,0
0,0,0,0,0,2,0,0,0,0,0,0,0,0,0,0,0,0,0,0,97,100,100,100,100,100,100,100,97,0,0,97,100,100,100,100,100,97,97,0,0,0,0,0,0,0,0,0
98,98,98,98,98,100,0,0,0,0,0,0,0,0,0,0,0,0,0,0,97,100,100,100,100,100,100,97,97,0,0,97,100,100,100,100,0,97,0,0,0,0,0,0,0,0,0,0
98,98,98,98,98,100,0,0,0,0,0,0,0,0,0,0,0,0,0,0,97,0,97,0,97,0,0,97,97,0,0,0,100,100,97,100,0,97,0,0,0,0,0,0,0,0,0,0
98,98,98,98,100,100,0,0,0,0,0,0,0,0,0,0,0,0,0,0,97,0,97,0,97,0,0,97,0,0,0,0,100,100,97,100,0,0,0,0,0,0,0,0,0,0,0,0
98,98,98,100,100,100,0,0,110,20,20,0,110,110,110,0,2,0,0,0,97,0,0,0,97,0,0,0,0,0,0,0,0,100,97,0,0,0,0,0,0,0,0,0,0,0,0,0
98,98,100,100,100,100,97,100,100,100,100,100,100,100,100,100,100,97,0,0,0,0,0,0,97,0,0,0,0,0,0,0,0,0,97,0,0,0,0,0,0,0,0,0,0,0,0,0
98,98,100,0,0,100,97,0,97,97,0,0,97,0,97,0,0,97,0,0,0,0,0,0,0,0,0,0,0,0,0,0,0,0,97,0,0,0,0,0,0,0,0,0,0,0,0,0
98,100,100,0,0,0,97,0,0,97,0,0,97,0,97,0,0,97,0,0,0,0,0,0,0,0,0,0,0,0,0,0,0,0,97,0,0,0,0,0,0,2,0,0,0,0,0,0
98,100,0,0,0,0,97,0,0,0,0,0,97,0,0,0,0,97,0,0,0,0,0,0,0,0,0,0,0,0,0,0,0,0,97,0,0,0,0,0,100,100,98,98,98,98,98,98
100,100,0,0,0,0,97,0,0,0,0,0,97,0,0,0,0,97,0,0,0,0,0,0,0,0,0,0,0,0,0,0,0,0,0,0,0,0,0,0,97,100,100,100,98,98,98,98
100,0,0,0,0,0,97,0,0,0,0,0,0,0,0,0,0,97,0,0,0,0,0,0,0,0,0,0,0,0,0,0,0,0,0,0,0,0,0,0,97,97,97,100,100,98,98,98
100,0,0,0,0,0,97,0,0,0,0,0,0,0,0,0,0,0,0,0,0,0,0,0,0,0,0,0,0,0,0,0,0,0,0,0,0,0,0,0,0,97,97,0,100,100,98,98
100,0,0,0,0,0,97,0,0,0,0,0,0,0,0,0,0,0,0,0,0,0,0,0,0,0,0,0,0,0,0,0,0,0,0,0,0,0,0,0,0,0,97,0,97,100,100,100
100,0,0,114,114,0,97,0,0,113,113,0,0,0,0,0,100,112,112,112,0,0,0,0,0,0,0,0,0,0,0,0,0,0,0,0,0,0,0,0,0,0,97,0,0,97,100,100
100,97,100,100,100,100,97,112,112,112,112,0,0,0,0,0,100,112,112,112,112,0,0,0,0,0,0,0,0,0,0,0,0,0,0,0,0,0,0,0,0,0,0,0,0,97,97,100
100,97,0,0,0,0,97,112,112,112,112,112,0,0,0,0,100,112,111,112,112,0,0,0,0,0,0,0,0,0,0,0,0,0,0,0,0,0,0,0,0,0,0,0,0,97,97,100
100,97,0,0,0,0,112,112,111,112,112,97,0,0,0,0,100,112,111,112,112,0,0,0,0,0,0,0,0,0,0,0,0,0,0,0,0,0,0,0,0,0,0,0,0,0,97,100
100,97,0,0,0,0,112,112,111,112,113,97,0,0,0,0,100,113,111,113,112,0,0,0,0,0,0,0,0,0,0,0,0,112,113,0,113,0,0,0,0,0,0,0,0,0,97,100
100,97,0,0,0,0,112,97,111,97,5,97,0,0,0,0,100,5,111,0,0,0,0,0,0,0,0,0,0,0,0,0,5,113,112,112,112,0,0,0,0,0,0,0,0,0,97,100
100,97,0,0,0,0,0,97,111,0,0,0,0,0,0,0,100,110,111,5,0,0,0,0,0,0,0,0,0,0,0,0,112,112,112,112,112,0,0,0,0,0,0,0,0,0,0,100
100,97,0,200,0,0,0,97,111,0,0,0,0,0,0,0,100,100,100,100,100,0,0,0,0,0,0,0,0,0,0,0,112,113,111,113,113,0,0,0,0,0,0,0,0,0,0,100
100,97,0,0,0,99,0,97,111,2,0,20,20,20,20,110,100,100,100,100,100,100,0,0,0,0,0,0,0,0,0,0,0,97,111,0,0,0,0,0,0,0,0,100,0,0,0,100
100,100,100,100,100,100,100,100,100,100,100,100,100,100,100,100,100,100,100,100,100,100,100,0,0,0,0,110,0,0,0,0,0,97,111,0,0,0,0,100,0,0,0,100,0,0,0,100
100,100,100,100,100,100,100,100,100,100,100,100,100,100,100,100,100,100,100,100,100,100,100,100,98,98,98,100,0,0,0,0,0,97,111,5,0,0,0,100,0,0,0,100,20,20,20,100
100,100,100,100,100,100,100,100,100,100,100,100,100,100,100,100,100,100,100,100,100,100,100,100,100,100,100,100,100,98,98,98,98,98,111,100,98,98,98,100,20,20,20,100,100,100,100,100
100,100,100,100,100,100,100,100,100,100,100,100,100,100,100,100,100,100,100,100,100,100,100,100,100,100,100,100,100,100,100,100,100,100,100,100,100,100,100,100,100,100,100,100,100,100,100,100
